5 4 4 4 4 4 4 7 0 0
6 3 3 3 3 3 3 8 0 0
6 3 3 3 3 3 3 8 0 0
6 2 2 2 2 2 2 8 0 0
6 1 1 1 1 1 1 8 0 0
6 1 1 1 1 1 1 8 0 0
6 1 1 1 1 1 1 8 0 0
6 1 1 1 1 1 1 8 0 0
6 1 1 1 1 1 1 8 0 0
6 1 1 1 1 1 1 8 0 0