5 4 4 4 4 4 4 7 3 3
6 3 3 3 3 3 3 8 3 3
6 3 0 3 3 0 3 8 3 3
6 2 2 2 2 2 2 8 3 3
6 1 1 1 1 1 1 8 3 3
6 1 1 1 1 1 1 8 3 3
6 1 1 1 1 1 1 8 3 3
6 1 1 1 1 1 1 8 3 3
6 1 1 1 1 1 1 8 3 3
6 1 1 1 1 1 1 8 3 3