12 12 12 12 12 12 12 12 12 12 12 12 12 12 12 12 12 12 12 12 12 12 12 12 12 12 12 12 12 12 12 12 12 12 12 12 12 12 12 12 12 12 13 13 13 12 12 12 12 12 12 12 12 12 12 13 13 12 12 12 12 12 12 12 
12 12 12 12 12 12 12 12 12 12 12 12 12 12 12 12 12 12 12 12 12 12 12 12 12 12 12 12 12 12 12 12 12 12 12 12 12 12 12 12 12 12 13 13 13 12 12 12 12 12 12 12 12 12 12 13 13 12 12 12 12 12 12 12 
12 12 11 11 11 11 11 11 11 11 11 11 11 11 11 11 11 11 11 11 11 11 11 11 11 11 11 11 11 11 11 11 11 11 11 11 11 11 11 11 11 11 13 13 13 11 11 11 11 11 11 11 11 11 11 13 13 11 11 11 11 11 12 12
12 12 11 10 10 10 10 10 10 10 10 10 10 10 10 10 10 10 10 10 10 10 10 10 10 10 10 10 10 10 10 10 10 10 10 10 10 10 10 10 10 10 13 13 13 11 10 10 10 10 10 10 10 10 10 13 13 10 10 10 10 11 12 12
12 12 11 10 10 10 10 10 10 10 10 10 10 10 10 10 10 10 10 10 10 10 10 10 10 10 10 10 10 10 10 10 10 10 10 10 10 13 13 13 13 13 13 13 13 10 10 10 10 10 10 10 10 10 10 13 13 10 10 10 10 11 12 12
12 12 11 15 16 16 16 16 16 16 16 16 16 16 16 16 16 16 16 16 16 16 16 16 17 10 10 10 10 10 10 10 10 10 10 10 10 13 13 13 13 13 13 13 13 10 10 10 10 10 10 10 10 10 10 13 13 10 10 10 10 11 12 12
12 12 11 22 14 14 14 14 14 14 14 14 14 14 14 14 14 14 14 14 14 14 14 14 18 10 10 10 10 10 10 10 10 10 10 10 10 13 13 10 10 30 10 10 10 10 10 10 10 10 10 10 10 10 10 13 13 10 10 10 10 11 12 12 
12 12 11 22 14 14 14 14 14 14 14 14 14 14 14 14 14 14 14 14 14 14 14 14 18 10 10 10 10 10 10 10 10 10 10 10 10 13 13 10 10 10 10 10 10 10 10 10 10 10 10 10 10 10 10 13 13 10 10 10 10 11 12 12
12 12 11 22 14 14 14 14 14 14 14 14 14 14 14 14 14 14 14 14 14 14 14 14 18 10 10 10 10 10 10 10 10 10 10 10 10 13 13 10 10 10 10 10 10 10 10 10 10 10 10 10 10 10 10 13 13 10 10 10 10 11 12 12
12 12 11 22 14 14 14 14 14 14 14 14 14 14 14 14 14 14 14 14 14 14 14 14 18 10 10 10 10 10 10 10 10 10 10 10 10 13 13 10 10 30 10 10 10 10 10 10 10 10 10 10 10 10 10 13 13 10 10 10 10 11 12 12 
12 12 11 22 14 14 14 14 14 14 14 14 14 14 14 14 14 14 14 14 14 14 14 14 18 10 10 13 13 13 13 13 13 13 13 13 13 13 13 10 10 10 10 10 10 10 10 10 10 10 10 10 10 10 10 13 13 10 10 10 10 11 12 12
12 12 11 22 14 14 14 14 14 14 14 14 14 14 14 14 14 14 14 14 14 14 14 14 18 10 10 13 13 13 13 13 13 13 13 13 13 13 13 10 10 10 10 10 10 10 10 10 10 10 10 10 10 10 10 13 13 10 10 10 10 11 12 12
12 12 11 22 14 14 14 14 14 14 14 14 14 14 14 14 14 14 14 14 14 14 14 14 18 10 10 13 13 13 10 10 10 10 10 10 10 10 10 10 10 10 10 10 10 10 10 10 10 10 10 10 10 10 10 13 13 10 10 10 10 11 12 12
12 12 11 22 14 14 14 14 14 14 14 14 14 14 14 14 14 14 14 14 14 14 14 14 18 10 10 13 13 13 10 10 10 10 10 10 10 10 10 10 10 10 10 10 10 10 10 10 10 10 10 10 10 10 10 13 13 10 10 10 10 11 12 12
12 12 11 22 14 14 14 14 14 14 14 14 14 14 14 14 14 14 14 14 14 14 14 14 18 10 10 13 13 13 10 10 10 10 10 10 11 10 10 10 10 10 10 10 10 10 10 10 10 10 10 10 10 10 10 13 13 10 10 10 10 11 12 12
12 12 11 22 14 14 14 14 14 14 14 14 14 14 14 14 14 14 14 14 14 14 14 14 18 10 10 13 13 13 10 10 10 10 10 10 10 10 10 10 10 10 10 10 10 10 10 11 10 10 10 10 10 10 10 13 13 10 10 10 10 11 12 12
12 12 11 22 14 14 14 14 14 14 14 14 14 14 14 14 14 14 14 14 14 14 14 14 18 10 10 13 13 13 10 10 10 10 10 10 10 10 10 10 10 10 10 10 10 10 10 10 10 10 10 10 10 10 10 13 13 10 10 10 10 11 12 12
12 12 11 22 14 14 14 14 14 14 14 14 14 14 14 14 14 14 14 14 14 14 14 14 18 10 10 13 13 13 10 10 10 10 10 10 10 10 10 10 10 10 10 10 13 13 13 13 13 13 13 13 13 13 13 13 13 10 10 10 10 11 12 12
12 12 11 22 14 14 14 14 14 14 14 14 14 14 14 14 14 14 14 14 14 14 14 14 18 10 10 13 13 13 10 10 10 10 10 10 10 10 10 10 10 10 10 10 13 13 13 13 13 13 13 13 13 13 13 13 13 10 10 10 10 11 12 12
12 12 11 21 20 20 20 20 20 20 20 20 20 20 20 20 20 20 20 20 20 20 20 20 19 10 10 13 13 13 10 10 10 10 10 10 10 10 10 10 10 10 10 10 13 13 10 10 10 10 10 10 10 10 10 13 13 10 10 10 10 11 12 12
12 12 11 10 10 10 10 10 10 10 10 10 10 10 10 10 10 10 10 10 10 10 10 10 10 10 10 13 13 13 10 10 10 10 10 10 10 10 10 10 10 10 10 10 13 13 10 10 10 10 10 10 10 10 10 13 13 10 10 10 10 11 12 12
12 12 11 10 10 10 30 10 10 10 30 10 10 10 30 10 10 11 10 10 11 10 10 11 10 10 10 13 13 13 10 10 10 10 10 10 10 10 10 10 10 10 10 10 13 13 10 10 10 10 10 10 10 10 10 13 13 10 10 10 10 11 12 12
12 12 11 10 13 13 13 13 13 13 13 13 30 10 10 10 10 10 10 10 10 10 10 10 10 10 10 13 13 13 10 10 10 10 10 10 10 10 10 10 10 10 10 10 13 13 10 10 10 10 11 10 10 10 10 13 13 10 10 10 10 11 12 12
12 12 11 10 13 13 13 13 13 13 13 13 10 10 10 10 10 10 10 10 10 10 10 10 10 10 10 13 13 13 10 10 10 10 10 10 10 10 10 10 10 10 10 10 13 13 10 10 10 10 10 10 10 10 10 13 13 10 10 10 10 11 12 12
12 12 11 10 13 13 13 13 13 13 13 13 10 10 10 10 10 10 10 10 10 10 10 10 10 10 10 13 13 13 10 10 10 10 10 10 10 30 30 11 30 30 10 10 13 13 10 10 10 10 10 10 10 10 10 13 13 10 10 10 10 11 12 12
12 12 11 10 13 13 13 13 13 13 13 13 10 10 10 10 10 10 10 10 10 10 30 30 10 30 10 13 13 13 10 10 10 10 10 10 10 10 10 10 10 10 10 10 13 13 10 10 10 10 10 10 10 10 10 13 13 10 10 10 10 11 12 12
12 12 11 10 13 13 13 13 13 13 13 13 13 13 13 13 13 13 13 13 13 13 13 13 13 13 13 13 13 13 13 13 13 13 13 13 13 13 13 13 13 13 13 13 13 13 13 13 13 13 13 13 13 13 13 13 13 10 10 10 10 11 12 12
12 12 11 10 13 13 13 13 13 13 13 13 13 13 13 13 13 13 13 13 13 13 13 13 13 13 13 13 13 13 13 13 13 13 13 13 13 13 13 13 13 13 13 13 13 13 13 13 13 13 13 13 13 13 13 13 13 10 10 10 10 11 12 12
12 12 11 10 10 10 10 10 10 10 10 10 10 10 10 10 10 13 13 10 10 10 10 10 10 10 10 13 13 13 10 10 10 10 10 10 10 10 10 10 10 10 10 10 10 10 10 10 10 10 10 10 10 10 10 10 10 10 10 10 10 11 12 12
12 12 11 10 10 10 10 10 10 10 10 10 10 10 10 10 10 13 13 10 10 10 10 10 10 10 10 13 13 13 10 10 10 10 10 10 10 10 10 10 10 10 10 10 10 10 10 10 10 10 10 10 10 10 10 10 10 10 10 10 10 11 12 12
12 12 11 10 10 10 10 10 10 10 10 10 10 10 10 10 10 13 13 10 30 10 30 10 10 10 10 13 13 13 10 10 10 10 10 10 10 10 10 10 10 10 10 10 10 10 10 10 10 10 10 10 10 10 10 10 10 10 10 10 10 11 12 12`
12 12 11 10 10 10 10 10 10 10 10 10 10 10 10 10 10 13 13 10 10 10 10 10 10 10 10 13 13 13 10 10 10 10 10 10 10 10 10 10 10 10 10 10 10 10 10 10 10 10 10 10 10 10 10 10 10 10 10 10 10 11 12 12
12 12 11 10 10 10 10 10 10 10 10 10 10 10 10 10 10 13 13 10 10 10 10 10 10 10 10 13 13 13 10 10 10 10 10 10 10 10 10 10 10 10 10 10 10 10 10 10 10 10 10 10 10 10 10 10 10 10 10 10 10 11 12 12
12 12 11 10 10 10 10 10 10 10 10 10 10 10 10 10 10 13 13 10 10 10 10 10 10 10 10 13 13 13 10 10 10 10 10 10 10 10 10 10 10 10 10 10 10 10 10 10 11 10 10 10 10 10 10 10 10 10 10 10 10 11 12 12
12 12 11 10 10 10 10 10 10 10 10 10 10 10 10 10 10 13 13 10 10 10 10 10 10 10 10 13 13 13 13 13 13 13 13 13 13 13 13 13 13 13 13 10 10 10 10 10 10 10 10 10 10 10 10 10 10 10 10 10 10 11 12 12
13 13 13 13 13 13 13 13 13 13 13 13 13 13 13 13 13 13 13 10 10 10 10 10 10 10 10 13 13 13 13 13 13 13 13 13 13 13 13 13 13 13 13 10 10 10 10 10 10 10 10 10 10 10 10 10 10 10 10 10 10 11 12 12
13 13 13 13 13 13 13 13 13 13 13 13 13 13 13 13 13 13 13 10 10 10 10 10 10 10 10 13 13 13 10 10 10 10 10 10 10 10 10 10 10 13 13 10 10 10 10 10 10 10 10 10 10 10 10 10 10 10 10 10 10 11 12 12
12 12 11 10 10 10 10 10 10 13 13 10 10 10 10 10 10 10 10 10 10 10 10 10 10 10 10 13 13 13 10 10 10 10 10 10 10 10 10 10 10 13 13 10 10 10 10 10 10 10 10 10 10 10 10 10 10 10 10 10 10 11 12 12
12 12 11 30 30 10 10 10 30 13 13 10 10 10 10 10 10 10 10 10 10 10 10 10 10 10 10 13 13 13 10 10 10 10 10 10 10 10 10 10 10 13 13 10 10 10 10 10 10 10 10 10 10 10 10 10 10 10 10 10 10 11 12 12
12 12 11 10 10 10 10 10 10 13 13 10 10 10 10 10 10 10 10 10 10 10 10 10 10 10 10 13 13 13 10 10 10 10 10 10 10 10 10 10 10 13 13 13 13 13 13 13 13 13 13 13 13 13 10 10 10 10 10 10 10 11 12 12
12 12 11 10 10 10 10 10 10 13 13 10 10 10 10 10 10 10 10 10 10 10 10 10 10 10 10 13 13 13 10 10 10 10 10 10 10 10 10 10 10 13 13 13 13 13 13 13 13 13 13 13 13 13 10 10 10 10 10 10 10 11 12 12
12 12 11 10 10 10 10 10 10 13 13 10 10 10 10 10 10 10 10 10 10 10 10 10 10 10 10 13 13 13 10 10 10 10 10 10 10 10 10 10 10 10 10 10 10 10 10 10 10 10 10 10 13 13 10 10 10 10 10 10 10 11 12 12
12 12 11 10 10 10 10 10 10 13 13 13 13 13 13 13 13 13 10 10 10 10 10 10 10 10 10 13 13 13 10 10 10 15 16 16 16 16 16 16 16 17 10 10 10 10 10 10 10 10 10 10 13 13 10 10 10 10 10 10 10 11 12 12 
12 12 11 10 10 10 10 10 10 13 13 13 13 13 13 13 13 13 10 10 10 10 10 10 10 10 10 13 13 13 10 10 10 22 14 14 14 14 14 14 14 18 10 10 10 10 10 10 10 10 10 10 13 13 13 13 13 13 13 13 13 13 13 13
12 12 11 10 10 10 10 10 10 10 10 10 10 10 10 10 13 13 10 10 10 10 10 10 10 10 10 13 13 13 10 10 10 22 14 14 14 14 14 14 14 18 10 10 10 10 10 10 10 10 10 10 13 13 13 13 13 13 13 13 13 13 13 13 
12 12 11 10 10 10 10 10 10 10 10 10 10 10 10 10 13 13 10 10 10 10 10 10 10 10 10 13 13 13 10 10 10 22 14 14 14 14 14 14 14 18 10 10 10 10 10 10 10 10 10 10 10 10 10 10 10 10 10 10 10 11 12 12
12 12 11 10 10 10 10 10 10 10 10 10 10 10 10 10 13 13 13 13 13 13 13 13 13 13 13 13 13 13 10 10 10 22 14 14 14 14 14 14 14 18 10 10 10 10 10 10 10 10 10 10 10 10 10 10 10 10 10 10 10 11 12 12
12 12 11 10 10 10 10 10 10 10 10 10 10 10 10 10 13 13 13 13 13 13 13 13 13 13 13 13 13 13 10 10 10 22 14 14 14 14 14 14 14 23 16 16 16 16 16 16 16 16 16 16 16 16 16 16 17 10 10 10 10 11 12 12
12 12 11 10 10 10 10 10 10 10 10 10 10 10 10 10 10 10 10 10 10 10 10 10 10 10 10 13 13 13 10 10 10 22 14 14 14 14 14 14 14 14 14 14 14 14 14 14 14 14 14 14 14 14 14 14 18 11 11 30 30 11 12 12
12 12 11 10 10 10 10 10 10 10 10 10 10 10 10 10 10 10 10 10 10 10 10 10 10 10 10 13 13 13 10 10 10 22 14 14 14 14 14 14 14 14 14 14 14 14 14 14 14 14 14 14 14 14 14 14 18 10 11 11 11 11 12 12
12 12 11 10 10 10 10 10 10 10 10 10 10 10 10 30 30 10 10 10 10 10 10 10 30 30 10 13 13 13 10 10 10 22 14 14 14 14 14 14 14 14 14 14 14 14 14 14 14 14 14 14 14 14 14 14 18 10 10 10 10 11 12 12
12 12 11 10 10 10 10 10 10 10 10 10 10 10 10 10 10 10 10 10 10 10 30 30 10 10 10 13 13 13 10 10 10 22 14 14 14 14 14 14 14 14 14 14 14 14 14 14 14 14 14 14 14 14 14 14 23 16 16 16 16 17 12 12
12 12 11 10 10 10 10 10 10 10 10 10 10 10 10 10 10 10 10 10 10 10 30 30 10 10 10 13 13 13 10 10 10 22 14 14 14 14 14 14 14 14 14 14 14 14 14 14 14 14 14 14 14 14 14 14 14 14 14 14 14 18 12 12
12 12 11 10 10 10 10 10 10 10 10 10 10 10 10 10 10 10 10 10 10 10 10 10 10 10 10 13 13 13 10 10 10 22 14 14 14 14 14 14 14 14 14 14 14 14 14 14 14 14 14 14 14 14 14 14 14 14 14 14 14 18 12 12
12 12 11 10 10 10 10 10 10 10 10 10 10 10 10 10 10 10 10 10 10 10 30 30 10 10 10 13 13 13 10 10 10 22 14 14 14 14 14 14 14 14 14 14 14 14 14 14 14 14 14 14 14 14 14 14 14 14 14 14 14 18 12 12
13 13 13 13 13 13 13 13 13 13 13 13 13 13 13 13 13 13 13 13 13 13 13 13 13 13 13 13 13 13 10 10 10 22 14 14 14 14 14 14 14 14 14 14 14 14 14 14 14 14 14 14 14 14 14 14 14 14 14 14 14 18 12 12
13 13 13 13 13 13 13 13 13 13 13 13 13 13 13 13 13 13 13 13 13 13 13 13 13 13 13 13 13 13 10 10 10 22 14 14 14 14 14 14 14 14 14 14 14 14 14 14 14 14 14 14 14 14 14 14 14 14 14 14 14 18 12 12
12 12 11 10 10 10 10 10 10 10 10 10 10 10 10 10 10 10 10 10 10 10 10 10 10 30 10 13 13 13 10 10 10 22 14 14 14 14 14 14 14 14 14 14 14 14 14 14 14 14 14 14 14 14 14 14 14 14 14 14 14 18 12 12
12 12 11 10 10 10 10 10 11 10 10 10 10 10 10 10 10 10 10 10 10 10 10 10 10 30 10 13 13 13 10 10 10 22 14 14 14 14 14 14 14 14 14 14 14 14 14 14 14 14 14 14 14 14 14 14 14 14 14 14 14 18 12 12
12 12 11 11 10 10 10 10 10 10 10 10 10 10 10 10 10 10 10 10 10 10 10 10 10 10 10 13 13 13 10 10 10 21 20 20 20 20 20 20 20 20 20 20 20 20 20 20 20 20 20 20 20 20 20 20 20 20 20 20 20 19 12 12
12 12 11 10 10 10 10 10 10 10 10 10 10 10 10 10 10 10 10 10 10 10 10 10 10 10 10 13 13 13 10 10 10 10 10 10 10 10 10 10 10 10 10 10 10 10 10 10 10 10 10 10 10 10 10 10 10 10 10 10 10 11 12 12
12 12 11 11 11 11 11 11 11 11 11 11 11 11 11 11 11 11 11 11 11 11 11 11 11 11 11 13 13 13 11 11 11 11 11 11 11 11 11 11 11 11 11 11 11 11 11 11 11 11 11 11 11 11 11 11 11 11 11 11 11 11 12 12
12 12 12 12 12 12 12 12 12 12 12 12 12 12 12 12 12 12 12 12 12 12 12 12 12 12 12 13 13 13 12 12 12 12 12 12 12 12 12 12 12 12 12 12 12 12 12 12 12 12 12 12 12 12 12 12 12 12 12 12 12 12 12 12 
12 12 12 12 12 12 12 12 12 12 12 12 12 12 12 12 12 12 12 12 12 12 12 12 12 12 12 13 13 13 12 12 12 12 12 12 12 12 12 12 12 12 12 12 12 12 12 12 12 12 12 12 12 12 12 12 12 12 12 12 12 12 12 12 